WWWWWWWWWWWWWWWWWWWWWWWWWWWWWW
WWWWWWWWGGGGPGGGGPGGGGWWWWWWWW
WWRRRRRWWGGGGGWWGGGGGWWRRRRRWW
WWSRRRRRdGGGGGWWGGGGGdRRRRRSWW
WWRRRRRWWGGGPGGGGPGGGWWRRRRRWW
WWWWWWWWGGGGGGGGGGGGGGWWWWWWWW
WSGGGGGGGGGGGGGGGGGGGGGGGGGGSW
WGGGGGGGGGGGGGGGGGGGGGGGGGGGGW
WWWWWGGGGGGGGGGGGGGGGGGGGWWWWW
WRRRDGGGGGGGGGGGGGGGGGGGGDRRRW
WRRRWGGGGGGGGGGGGGGGGGGGGWRRRW
WWWWWGGGGGGGGGGGGGGGGGGGGWWWWW
WGGGGGGGGGGGGGWdWGGGGGGGGGGGGW
WGGGGGGGGGGGGWWGWWGGGGGGGGGGGW
WGGGGGGGGGGGWWGGGWWGGGGGGGGGGW
WGGGGGGGGGGGWGPGPGWGGGGGGGGGGW
WGGGGGGGGGGGWGGEGGWGGGGGGGGGGW
WGGGGGGGGGGGWGPGPGWGGGGGGGGGGW
WGGGGGGGGGGGWGGGGGWGGGGGGGGGGW
WWWWWWWWWWWWWWWWWWWWWWWWWWWWWW
