BBBBBBBBBBBBBBBBBBBBBBBBBBBBBB
BGGGGGGGGGGGGGGGGGEGGGGGGGGGGB
BWWWWWWWWGGGGGGGGGGGGGGGGGGGGB
BWRRRRRRDGGGGGGGGTGGGGGGTGGGGB
BWRRRRRRDGGGGGGGGGGGGGGGGGGGGB
BWRRRRRRWGGGGGGGGGGGGGGGGGGGGB
BWWWWWWWWGGGWWWWWWWGGGGGGGGGGB
BGGGGGGGGGGGGGGWWGGGWWWWGGGGGB
BGGGGGGGGTGGGGGGGGWWWWWWWWGGGB
BGGGGGTGGGGGGGGGWGWWWWGGGGGGGB
BGGGGGGGGGGGGGGGGGGGGGGGGGGGGB
BWWWWWWWWWWWGGGGGGGGWWWWGGGGGB
BWWWGGGGGGGGGGWWGGGGGGGGGGGGGB
BGGGGGGGGGGGGGGGGGGGGGGGGTTGGB
BGTTGGGGSGGGGGGGGGGGGGGGGGGGGB
BGTGGGGGGGGGGGGGGGGGGGGGGTGGGB
BGGGGGGGGGGGGGGGGGWWWWWWWWWWWB
BGGGGGGWWWWGGGGGGGGGWWWGGGWWWB
BGGGGGGGGGGGGGGGGGGGGGGGSGGGGB
BBBBBBBBBBBBBBBBBBBBBBBBBBBBBB
