BBBBBBBBBBBBBBBBBBBBBBBBBBBBBB
BWWWWWWWGGGGPGGGGPGGGGWWWWWWWB
BWRRRRRWWGGGGGFFGGGGGWWRRRRRWB
BWSRRRRRDGGGGGFFGGGGGDRRRRRSWB
BWRRRRRWWGGGPGEGGPGGGWWRRRRRWB
BWWWWWWWGGGGGGGGGGGGGGWWWWWWWB
BGGGGGGGGGGGGGGGGGGGGGGGGGGGGB
BGGGGGGGGGGGGGGGGGGGGGGGGGGGGB
BWWWWGGGGGGGGGGGGGGGGGGGGWWWWB
BRRRDGGGGGGGGGGGGGGGGGGGGDRRRB
BRRRWGGGGGGGGGGGGGGGGGGGGWRRRB
BWWWWGGGGGGGGGGGGGGGGGGGGWWWWB
BGGGGGGGGGGGGGGGGGGGGGGGGGGGGB
BGGGGGGGGGGGGGGGGGGGGGGGGGGGGB
BGGGGGGGGGGGGGGGGGGGGGGGGGGGGB
BGGGGGGGGGGPGGGGGGPGGGGGGGGGGB
BGGGGGGGGGGPGGGGGGPGGGGGGGGGGB
BGGGGGGGGGGPGGGGGGPGGGGGGGGGGB
BGGGGGGGGGGPGGGSGGPGGGGGGGGGGB
BBBBBBBBBBBPBBBBBBPBBBBBBBBBBB