WWWWWWWWWWWWWWWWWWWWWWWWWWWWWW
WWWWWWWWGGGGPGGGGPGGGGWWWWWWWW
WWRRRRRWWGGGGGWWGGGGGWWRRRRRWW
WWSRRRRRdGGGGGWWGGGGGdRRRRRSWW
WWRRRRRWWGGGPGGGGPGGGWWRRRRRWW
WWWWWWWWGGGGGGGGGGGGGGWWWWWWWW
WEGGGGGGGGGGGGGGGGGGGGGGGGGGGW
WGGGGGGGGGGGGGGGGGGGGGGGGGGGGW
WWWWWGGGGGGGGGGGGGGGGGGGGWWWWW
WRRRDGGGGGGGGGGGGGGGGGGGGDRRRW
WRRRWGGGGGGGGGGGGGGGGGGGGWRRRW
WWWWWGGGGGGGGGGGGGGGGGGGGWWWWW
WGGGGGGGGGGGGGGGGGGGGGGGGGGGGW
WGGGGGGGGGGGGGGGGGGGGGGGGGGGGW
WGGGGGGGGGGGGGGGGGGGGGGGGGGGGW
WGGGGGGGGGGWGGGGGGWGGGGGGGGGGW
WGGGGGGGGGGWGGGGGGWGGGGGGGGGGW
WGGGGGGGGGGWGGGGGGWGGGGGGGGGGW
WGGGGGGGGGGWGGGSGGWGGGGGGGGGGW
WWWWWWWWWWWWWWWWWWWWWWWWWWWWWW