WWWWWWWWWWWWWWWWWWWWWWWWWWWWWW
WWWWWWWWGGGGPGGGGPGGGGWWWWWWWW
WWRRRRRWWGG?GGFFGG?GGWWRRRRRWW
WWSRRRRRdGG?GGFFGG?GGDRRRRRSWW
WWRRRRRWWGG?PGGGGP?GGWWRRRRRWW
WWWWWWWWGGGGGGGGGGGGGGWWWWWWWW
WEGGGGGGGGGGGGGGGGGGGGGGGGGGGW
WGGGGGGGGGGGGGGGGGGGGGGGGGGGGW
WWWWWGGGGGGGGGGGGGGGGGGGGWWWWW
WRRRDGGGGGGGGGGGGGGGGGGGGDRRRW
WRRRWGGGGGGGGGGGGGGGGGGGGWRRRW
WWWWWGGGGGGGGGGGGGGGGGGGGWWWWW
WGGGGGGGGGGGGGGGGGGGGGGGGGGGGW
WGGGGGGGGGGGGGGGGGGGGGGGGGGGGW
WGGGGGGGGGGGGGGGGGGGGGGGGGGGGW
WGGGGGGGGGGPGGGGGGPGGGGGGGGGGW
WGGGGGGGGGGPGGGGGGPGGGGGGGGGGW
WGGGGGGGGGGPGGGGGGPGGGGGGGGGGW
WGGGGGGGGGGPGGGSGGPGGGGGGGGGGW
WWWWWWWWWWWWWWWWWWWWWWWWWWWWWW