WWWWWWWWWWWWWWWWWWWWWWWWWWWWWW
WGGGGGGGGGGGGGGGGGEGGGGGGGGGGW
WWWWWWWWWGGGGGGGGGGGGGGGGGGGGW
WWRRRRRRDGGGGGGGGTGGGGGGTGGGGW
WWRRRRRRDGGGGGGGGGGGGGGGGGGGGW
WWRRRRRRWGGGGGGGGGGGGGGGGGGGGW
WWWWWWWWWGGGWWWWWWWGGGGGGGGGGW
WGGGGGGGGGGGGGGWWGGGWWWWGGGGGW
WGGGGGGGGTGGGGGGGGWWWWWWWWGGGW
WGGGGGTGGGGGGGGGWGWWWWGGGGGGGW
WGGGGGGGGGGGGGGGGGGGGGGGGGGGGW
WWWWWWWWWWWWGGGGGGGGWWWWGGGGGW
WWWWGGGGGGGGGGWWGGGGGGGGGGGGGW
WGGGGGGGGGGGGGGGGGGGGGGGGTTGGW
WGTTGGGGSGGGGGGGGGGGGGGGGGGGGW
WGTGGGGGGGGGGGGGGGGGGGGGGTGGGW
WGGGGGGGGGGGGGGGGGWWWWWWWWWWWW
WGGGGGGWWWWGGGGGGGGGWWWGGGWWWW
WGGGGGGGGGGGGGGGGGGGGGGGSGGGGW
WWWWWWWWWWWWWWWWWWWWWWWWWWWWWW
