WWWWWWWWWWWWWWWWWWWWWWWWWWWWWW
WWWWWWWWGGGGPGGGGPGGGGWWWWWWWW
WWRRRRRWWGGGGGFFGGGGGWWRRRRRWW
WWSRRRRRdGGGGGFFGGGGGDRRRRRSWW
WWRRRRRWWGGGPGGGGPGGGWWRRRRRWW
WWWWWWWWGGGGGGGGGGGGGGWWWWWWWW
WEGGGGGGGGGGGGGGGGGGGGGGGGGGGW
WGGGGGGGGGGGGGGGGGGGGGGGGGGGGW
WWWWWGGGGGGGGGGGGGGGGGGGGWWWWW
WRRRDGGGGGGGGGGGGGGGGGGGGDRRRW
WRRRWGGGGGGGGGGGGGGGGGGGGWRRRW
WWWWWGGGGGGGGGGGGGGGGGGGGWWWWW
WGGGGGGGGGGGGGGGGGGGGGGGGGGGGW
WGGGGGGGGGGGGGGGGGGGGGGGGGGGGW
WGGGGGGGGGGGGGGGGGGGGGGGGGGGGW
WGGGGGGGGGGPGGGGGGPGGGGGGGGGGW
WGGGGGGGGGGPGGGGGGPGGGGGGGGGGW
WGGGGGGGGGGPGGGGGGPGGGGGGGGGGW
WGGGGGGGGGGPGGGSGGPGGGGGGGGGGW
WWWWWWWWWWWWWWWWWWWWWWWWWWWWWW