BBBBBBBBBBBBBBBBBBBBBBBBBBBBBB
BGGGGGGGGGGGGGGGGGEGGGGGGGGGGB
BWWWWWWWWGGGGGGGGGGGGGGGGGGGGB
BWRRRRRRDGGGGGGGGGGGGGGGGGGGGB
BWRRRRRRDGGGGGGGGGGGGGGGGGGGGB
BWRRRRRRWGGGGGGGGGGGGGGGGGGGGB
BWWWWWWWWGGGWWWWWWWGGGGGGGGGGB
BGGGGGGGGGGGGGGWWGGGWWWWGGGGGB
BGGGGGGGGGGGGGGGGGWWWWWWWWGGGB
BGGGGGGGGGGGGGGGWGWWWWGGGGGGGB
BGGGGGGGGGGGGGGGGGGGGGGGGGGGGB
BWWWWWWWWWWWGGGGGGGGWWWWGGGGGB
BWWWGGGGGGGGGGWWGGGGGGGGGGGGGB
BGGGGGGGGGGGGGGGGGGGGGGGGGGGGB
BGGGGGGGSGGGGGGGGGGGGGGGGGGGGB
BGGGGGGGGGGGGGGGGGGGGGGGGGGGGB
BGGGGGGGGGGGGGGGGGWWWWWWWWWWWB
BGGGGGGWWWWGGGGGGGGGWWWGGGWWWB
BGGGGGGGGGGGGGGGGGGGGGGGSGGGGB
BBBBBBBBBBBBBBBBBBBBBBBBBBBBBB
