WWWWWWWWWWWWWWWWWWWWWWWWWWWWWW
WWWWWWWWGGGGPGGGGPGGGGWWWWWWWW
WWRRRRRWWGGGGGWWGGGGGWWRRRRRWW
WWSRRRRRdGGGGGWWGGGGGdRRRRRSWW
WWRRRRRWWGGGPGGGGPGGGWWRRRRRWW
WWWWWWWWGGGGGGGGGGGGGGWWWWWWWW
WSGGGGGGGGGGGGGGGGGGGGGGGGGGSW
WGGGGGGGGGGGGGGGGGGGGGGGGGGGGW
WWWWWGGGGGGGGWWWGGGGGGGGGWWWWW
WRRRDGGGGGGGGWWWGGGGGGGGGDRRRW
WRRRWGGGGGGGGGGGGGGGGGGGGWRRRW
WWWWWGGGGGGGGGGGGGGGGGGGGWWWWW
WGGGGGGGGGGGGGWdWGGGGGGWWWWGGW
WGGGGGGGGGGGGWWGWWGGGGGWGGGGGW
WdWWWWWWGGGGWWGGGWWDWWWWGGWGGW
WRRRRRRWGGGGWGPGPGWGGGGWGGWGGW
WdWWWRRWGGGGWGGEGGWGPGGWWGWGGW
WRRWWRRWGGGGWGPGPGWGGPGDGGWGGW
WRRWWRRdGGGGWGGGGGWGGGGWGGWGGW
WWWWWWWWWWWWWWWWWWWWWWWWWWWWWW
