WWWWWWWWWWWWWWWWWWWWWWWWWWWWWWWWWWWWWWWWWWWWWWWWWW
WSRRRRRRRRWRRRRRWRRRRRRRWRRRRRRRRRWRRRWRdGGGGWEWWW
WWWWWWWWWRDRRRRRWRWWWWWRWWWRWWWDWRRRWRRRWGGGGWGWWW
WRRRRRRRRRWWWWWWWRWRRRRRRRRRRRWRWWWWWWWWWGGGGWGWWW
WRRRRWWWWWGGDRRRRRWRWWWWWWWWWRWRRRRRRRRWWWRRWWGWWW
WRRRRWGGGGGGWWWWWWWRWRRRRRRRRRWWWWWWWWRWWGGGGWGWWW
WRRRRdGGGGGGWSRRRRdRWWWWRWWDWWWRRRRRRRRWWGGGGGGWWW
WWWWWWWWWWWWWWWWWWWWWWWWWWWWWWWWWWWWWWWWWWWWWWWWWW