WWWWWWWWWWWWWWWWWWWWWWWWWWWWWW
WWWWWWWWGGGGPGGGGPGGGGWWWWWWWW
WWRRRRRWWGGGGGWWGGGGGWWRRRRRWW
WWSRRRRRdGGGGGWWGGGGGdRRRRRSWW
WWRRRRRWWGGGPGGGGPGGGWWRRRRRWW
WWWWWWWWGGGGGGGGGGGGGGWWWWWWWW
WSGGGGGGGGGGGGGGGGPGPGGGGGGGSW
WGGGGGGGWGGGGGWGGGGGWGGGGGGGGW
WWWWWGGGWWGGGWWWGGGWWGGGGWWWWW
WRRRDGGGGGGGGWWWGGGGGGGGGDRRRW
WRRRWGGGGWGGGGGGGGGWGGGGGWRRRW
WWWWWGGGWWGGGGGGGGWWWGGGGWWWWW
WGGGGGGGWGGGGGWdWGGWGGGWWWWGGW
WGGGGGGGGGGGGWWGWWGGGGGWGGGGGW
WdWWWWWWGGGGWWGGGWWdWWWWGGWGGW
WRRRRRRWGGGGWGPGPGWRGGGWGGWGGW
WDWWWRRWGGGGWGGEGGWRRRGWWGWGGW
WRRWWRRWGGGGWGPGPGWGGRRDGGWGGW
WRRWWRRdGGGGWGGGGGWPPPPWGGWGGW
WWWWWWWWWWWWWWWWWWWWWWWWWWWWWW
