WWWWWWWWWWWWWWWWWWWWWWWWWWWWWW
WGGGGGGGGGGGGGRRRRRRRRRRRRRRRW
WWWWWWWWWGGGGGWRWRWRWRWRWRWRRW
WWRRRRRRDGGGGGGGGTGGGGGGTGGRRW
WWRRRRRRWGGGGGGGGGGGGGGGGGGGGW
WWRRRRRRWGGGGGGGGGGGGGGGEGGGGW
WWWWWWWWWGGGWWWWWWWGGGGGGGGGGW
WGGDGGGGGGGGGGGWWGGGWWWWGGGGGW
WGGWGGGGGTGGGGGGGGWWWWWWWWGGGW
WTTTGGTGGGGGGGGGWGWWWWGGGGGGGW
WGGGGGGGGTGGGGGGGGGGGGGGGGGGGW
WWWWWWWWWWWWGGGGGGGGWWWWGGGGGW
WWWWGGGGGGGGGGWWGGGGGGGGGGGGGW
WGGGGGGGGGGGGGGGGGGGGGGGGWTTTW
WGGTGGGGSGTTTGGGGGGGWGGGGDGGGW
WGGGGGGGGGGGTGGGGGGGWGGGGWGGGW
WWDWGGGGGGGGGGGTGGWWWWWWWWWWWW
WGGWGGWWWWGGGGGGGGGWWWGGGWWWWW
WGGWGGGGGGGGGGGGGGGGGGGSGGGGWW
WWWWWWWWWWWWWWWWWWWWWWWWWWWWWW